9
11 32 39 29 75 79 6 9 26
30 67 15 51 63 0 35 31 16
45 52 44 7 40 71 3 41 69
76 60 55 33 23 10 36 78 65
34 2 13 58 17 66 8 5 74
#53 59 64 80 50 47 12 72 1
62 4 68 14 24 25 77 46 57
21 42 27 73 37 54 49 18 19
22 48 56 38 43 70 28 20 61
