9
54 36 71 8 3 39 33 65 7
61 45 47 23 30 12 55 60 59
72 53 9 27 2 73 67 74 29
20 75 16 13 25 38 58 40 48
50 14 42 52 80 77 79 6 26
62 32 28 51 43 0 34 10 63
49 78 4 44 17 31 46 37 76
69 64 22 21 11 56 41 18 19
5 24 57 35 66 70 1 15 68
