14
1 52 60 133 132 49 163 193 8 135 11 68 183 105
100 48 2 161 123 134 59 67 5 7 14 171 99 16
55 96 91 136 158 51 58 65 63 138 18 15 13 17
95 54 131 98 94 102 50 165 117 19 12 6 64 139
44 46 128 88 186 180 57 69 3 20 106 111 112 103
192 47 173 126 168 182 109 140 61 143 108 104 62 70
178 89 97 185 157 56 162 130 71 184 141 22 107 110
125 93 53 85 45 166 164 101 10 195 23 66 28 187
190 86 92 122 43 124 4 137 194 118 26 146 21 114
159 155 153 160 90 147 142 150 177 9 72 144 74 115
151 179 175 191 152 129 188 172 77 167 24 119 174 73
41 39 127 176 32 145 83 79 34 35 169 116 29 148
84 37 82 42 87 181 154 33 25 170 113 0 27 30
38 40 121 81 156 149 189 31 80 36 120 76 78 75
