12
81 109 112 2 83 134 12 133 78 53 9 59
33 79 113 124 82 6 87 55 89 76 140 13
106 37 75 7 3 45 51 44 1 85 14 84
98 111 126 80 132 127 128 5 136 130 114 118
131 116 48 41 125 137 56 21 30 47 11 63
43 49 61 69 4 107 115 58 139 88 15 46
121 104 72 42 36 0 108 16 105 60 52 86
77 103 8 31 70 110 101 10 26 57 23 54
135 35 129 94 66 117 32 142 100 50 19 90
40 68 123 71 64 102 143 17 119 27 25 95
138 38 74 120 122 91 29 92 20 97 96 18
34 99 39 28 141 73 62 93 65 67 22 24
