8
22 50 24 12 10 59 39 7
37 44 18 33 46 54 20 21
8 0 17 43 56 6 55 11
40 14 62 2 45 1 38 26
29 5 13 58 36 9 51 31
53 41 63 30 42 61 35 52
19 15 3 16 34 57 32 48
27 47 28 25 23 49 4 60
