9
30 56 36 55 18 41 38 80 2
21 69 46 5 40 35 75 59 9
27 10 33 8 61 39 14 47 78
60 12 31 0 72 68 22 11 49
4 1 63 25 54 77 42 20 71
28 79 57 26 34 48 45 29 76
51 23 64 67 3 74 66 53 19
73 70 24 13 43 50 44 6 17
58 52 65 62 7 15 37 32 16
