8
53 59 46 29 49 14 6 39
41 19 33 2 56 12 35 15
20 25 48 36 21 17 45 34
1 23 4 10 22 50 18 55
58 62 61 0 31 47 60 16
27 11 30 54 8 26 43 28
63 13 42 38 52 44 9 40
3 24 7 37 32 57 51 5
