8
43 60 17 4 27 14 32 29
44 45 20 41 55 19 9 37
24 13 31 28 62 22 16 47
59 33 61 46 57 48 11 56
58 54 40 6 42 8 53 38
39 1 12 5 63 3 0 10
25 7 51 18 50 26 34 21
49 36 30 52 35 23 2 15
