12
107 109 2 39 44 88 81 115 50 129 8 84
43 80 78 55 117 135 7 143 0 52 16 11
104 83 105 4 10 91 94 47 12 46 113 54
1 79 74 6 132 142 27 13 85 114 86 53
110 37 127 3 116 18 42 111 56 40 14 9
72 67 100 101 38 87 21 128 141 112 123 61
77 76 75 108 45 5 22 122 137 15 121 134
140 65 136 25 49 48 124 59 96 57 90 120
71 36 82 99 17 106 138 139 24 131 93 89
70 103 30 41 126 102 69 20 51 63 130 119
31 34 28 35 118 29 19 133 97 58 26 95
68 33 62 73 32 66 64 98 125 60 92 23
