15
143 140 55 6 62 219 64 108 69 66 13 17 115 16 15
60 58 224 7 141 145 56 112 107 181 149 150 111 184 68
144 3 147 52 175 109 9 102 113 153 180 110 116 152 14
5 57 1 200 199 51 171 63 2 10 12 117 190 18 8
139 104 59 138 196 177 4 70 182 178 218 151 155 20 185
174 100 53 96 207 61 118 222 206 189 114 154 19 176 67
213 105 45 101 106 54 148 201 80 129 203 72 204 156 71
98 97 103 48 210 220 40 202 188 209 205 73 21 121 183
172 135 133 198 221 157 179 65 136 130 122 186 11 124 22
46 49 99 94 211 212 164 217 160 146 216 165 119 163 120
197 50 173 166 193 187 134 195 192 126 23 158 81 161 24
42 0 137 142 92 127 170 26 79 76 30 208 82 25 74
44 93 47 168 90 89 132 78 36 33 34 162 123 27 84
91 215 214 167 223 131 39 37 75 159 83 128 88 29 31
41 194 95 191 43 38 169 85 87 35 32 77 86 125 28
