11
39 40 93 6 112 10 109 13 1 3 114
37 95 96 0 44 42 55 46 41 97 48
5 2 73 20 92 94 18 43 76 7 28
78 47 16 75 71 113 80 56 77 49 8
72 66 70 89 91 90 82 21 51 19 100
45 116 33 85 102 98 86 57 11 15 60
115 23 81 9 67 64 63 58 79 99 111
84 69 4 104 68 107 120 52 17 29 61
24 101 32 74 25 34 108 62 103 26 88
53 30 36 106 35 38 105 118 50 22 54
27 110 31 65 87 119 14 59 117 12 83
