12
80 127 38 82 41 8 124 46 112 113 85 55
2 5 64 141 3 117 10 14 53 90 15 49
78 37 79 105 71 45 107 48 111 58 13 26
109 108 7 104 83 31 4 84 115 91 143 16
43 137 40 88 128 75 51 132 11 52 57 18
50 39 81 142 86 131 101 130 9 54 116 60
114 133 24 1 56 87 118 61 126 44 106 0
122 99 138 25 6 140 47 103 20 17 120 89
134 36 102 12 139 67 123 30 129 93 21 59
69 110 77 136 119 135 29 27 94 66 65 97
76 35 125 72 73 95 98 96 42 92 63 62
34 100 33 70 74 32 28 23 121 19 22 68
