10
98 3 38 36 43 4 35 94 86 83
85 23 66 32 55 33 6 41 96 74
37 68 2 99 44 76 89 56 90 8
62 97 47 34 61 28 72 10 69 13
30 92 31 67 1 73 88 48 12 91
7 64 24 53 57 15 16 5 0 70
46 80 81 17 79 58 49 21 11 65
84 29 75 52 22 40 26 51 77 27
60 78 45 87 71 54 39 93 9 59
18 25 95 50 20 63 14 82 19 42
