9
3 73 7 58 9 22 49 76 44
62 69 79 33 29 26 42 60 19
13 2 36 52 51 72 8 5 56
16 0 61 28 11 39 15 41 48
4 75 55 47 63 71 45 10 35
25 80 31 30 43 68 27 23 37
77 70 14 64 34 53 17 21 6
59 20 74 54 38 66 78 18 40
67 50 12 24 1 32 46 57 65
