8
57 23 7 33 41 17 42 8
38 3 6 52 9 55 36 46
61 59 19 30 40 28 16 13
1 31 49 2 51 60 29 18
63 10 48 53 4 11 44 32
35 56 21 58 24 39 0 47
20 25 62 15 22 37 27 43
45 54 14 34 12 50 26 5
