8
40 29 45 6 34 62 59 31
61 58 21 37 57 41 0 4
60 42 33 13 17 1 2 44
54 32 43 22 53 3 19 12
63 26 8 7 46 27 14 51
52 10 24 9 28 23 50 20
35 16 55 38 36 5 49 18
25 48 11 56 47 15 30 39
