8
57 17 34 32 24 44 22 49
37 18 4 2 40 13 0 6
42 53 36 60 26 47 23 35
20 27 28 61 10 3 43 25
63 52 7 41 54 50 29 8
19 5 1 21 31 11 30 62
48 46 15 33 14 12 58 45
56 51 16 39 9 38 55 59
