11
95 71 66 40 59 38 75 43 47 49 56
88 2 98 108 46 0 76 99 69 72 25
1 51 44 100 112 6 5 63 101 11 78
3 39 114 45 12 82 68 120 20 116 80
96 65 64 67 97 16 13 73 42 81 7
94 52 41 103 118 77 14 8 53 21 57
4 9 70 36 113 117 29 102 17 18 10
115 28 61 79 83 37 23 15 48 55 86
74 91 104 35 89 111 110 24 54 50 84
92 34 30 109 33 26 60 22 58 19 62
119 106 27 32 105 93 90 31 85 107 87
