9
38 62 39 48 14 19 11 35 41
4 3 23 72 53 9 69 31 73
42 80 1 77 0 24 79 17 74
46 6 60 27 52 50 40 10 34
36 29 21 56 49 59 63 20 68
30 78 2 37 58 15 22 5 47
7 65 70 28 8 33 61 32 75
64 26 57 18 13 66 12 67 44
71 43 54 25 55 51 76 16 45
