15
102 59 56 143 111 63 4 112 65 11 151 117 114 15 115
55 104 142 144 1 150 147 201 68 9 113 188 67 77 12
54 145 3 62 57 194 71 6 108 7 8 64 16 155 118
2 5 105 53 203 110 212 10 107 215 205 69 152 206 14
146 51 198 101 175 156 178 200 182 17 66 184 19 123 13
52 173 216 179 94 58 177 61 181 218 76 27 149 128 72
49 222 106 137 187 174 213 183 121 120 0 204 116 70 217
199 97 223 140 99 83 148 165 224 122 75 73 210 18 21
98 202 48 103 92 176 192 186 126 24 74 153 60 26 20
37 100 135 211 197 221 196 214 180 125 219 109 79 220 22
47 46 50 96 168 138 132 190 34 167 157 162 119 32 36
141 41 45 93 38 171 129 95 209 163 191 30 78 84 159
89 42 139 91 136 130 170 86 90 164 29 185 23 207 28
166 169 193 172 85 131 25 133 208 87 33 82 81 127 154
195 43 44 40 134 39 35 158 88 189 31 161 160 124 80
