8
39 53 41 5 25 27 7 28
18 59 23 44 45 13 52 48
51 0 50 11 34 37 60 61
58 2 1 26 55 38 33 54
6 4 17 56 3 36 35 63
21 31 29 47 22 40 46 8
19 42 49 16 57 10 14 15
32 43 62 30 24 12 9 20
