13
121 53 95 50 51 62 54 147 98 4 61 13 12
159 7 9 42 167 130 93 156 146 127 123 14 63
90 122 143 85 119 126 164 8 91 6 60 55 150
145 89 2 157 88 94 15 162 59 56 17 0 152
144 86 48 3 117 148 154 5 92 11 101 125 57
141 84 45 111 1 115 99 10 149 114 120 131 163
110 47 140 137 133 34 87 58 102 108 19 16 100
44 80 41 52 83 74 139 36 96 20 64 104 26
160 129 30 168 135 49 134 18 23 128 97 25 21
38 43 40 79 118 132 66 142 153 151 166 24 67
46 39 72 158 124 81 77 32 155 109 68 165 29
113 33 75 116 73 161 27 69 28 112 106 22 70
82 35 78 107 105 37 31 136 76 138 71 103 65
