11
0 90 101 60 42 74 7 30 3 2 40
44 1 71 39 113 115 11 49 52 54 102
51 79 47 35 46 100 25 78 50 8 18
6 5 76 72 98 37 14 34 48 86 12
68 118 96 110 119 38 21 109 10 17 59
31 70 95 16 41 83 23 61 114 13 45
63 67 57 69 106 93 75 104 53 9 103
111 112 107 94 80 97 64 56 62 58 55
89 32 33 4 88 77 15 84 20 87 116
43 91 66 24 117 65 73 105 108 99 29
120 92 28 36 81 22 27 19 82 85 26
