10
48 80 61 13 1 11 36 43 67 95
35 99 63 14 57 70 7 62 15 6
23 92 84 66 73 37 42 89 45 94
59 53 12 64 40 25 16 71 90 44
96 88 78 83 68 86 91 8 34 97
5 29 69 26 4 2 31 21 46 24
81 33 54 49 82 28 38 39 87 79
72 9 30 20 17 93 32 18 47 19
58 0 3 77 65 41 56 27 55 51
60 98 50 22 10 85 76 75 52 74
