15
5 106 200 103 110 145 109 1 59 178 6 14 24 114 113
147 56 53 107 217 62 199 9 64 204 117 17 23 120 111
104 2 176 48 142 193 58 202 7 10 152 65 153 20 11
144 55 57 105 149 72 70 69 185 21 66 115 74 18 12
96 52 198 102 214 3 77 108 60 13 175 118 19 182 67
50 171 4 166 180 187 211 15 206 179 184 116 68 154 146
98 218 140 203 138 169 0 201 148 8 215 71 121 73 16
216 97 93 181 165 63 101 112 190 25 79 35 183 221 81
174 47 139 54 196 151 143 167 191 75 124 159 157 128 61
99 195 173 131 212 186 224 122 150 156 76 162 220 205 158
136 219 87 49 197 177 163 135 223 36 80 155 188 78 27
90 95 43 168 141 194 51 222 210 160 83 119 123 22 207
44 100 133 91 134 89 172 86 30 85 192 127 29 34 208
46 92 94 40 88 129 130 209 39 126 164 161 26 84 32
45 42 170 38 137 41 213 132 33 37 189 125 28 31 82
