8
52 17 63 46 34 15 8 16
37 28 14 40 47 4 13 11
50 62 20 53 41 10 25 51
61 27 3 22 26 33 12 45
58 9 1 32 54 44 42 38
7 6 0 18 35 31 23 36
2 49 48 19 59 57 39 43
56 5 29 60 24 21 30 55
