9
25 33 55 34 40 10 8 2 62
11 52 80 47 54 61 39 4 76
57 51 58 7 73 24 1 75 43
71 45 6 44 50 19 74 0 64
53 48 22 59 56 13 9 21 63
16 20 66 72 67 26 3 32 36
78 60 69 27 38 77 68 35 31
49 23 14 65 30 42 29 18 28
79 41 17 70 37 15 46 12 5
