13
94 89 8 5 4 126 91 110 127 90 146 56 14
48 145 86 95 61 52 138 136 11 55 142 0 53
164 148 47 7 44 154 165 156 58 10 13 149 129
2 1 119 124 78 50 150 57 15 54 131 100 17
46 159 49 42 139 118 141 37 167 125 98 66 12
92 120 166 143 6 168 161 74 96 97 123 63 151
93 3 160 40 114 132 83 60 16 105 107 103 68
116 41 85 115 71 108 9 38 128 155 64 19 137
162 102 157 87 43 51 59 130 70 101 144 21 75
111 88 80 84 117 82 135 30 112 147 28 62 27
121 29 113 122 32 20 81 153 99 26 18 33 25
45 140 163 36 76 106 79 23 67 134 152 65 73
109 34 39 35 77 158 31 133 72 22 24 69 104
