9
28 31 60 36 11 29 42 40 3
26 35 23 55 66 37 44 9 79
46 59 6 41 4 76 73 5 38
21 74 56 10 33 39 78 13 45
20 30 24 15 71 77 1 12 67
68 65 64 70 32 7 16 0 62
34 8 50 72 53 61 27 63 17
2 14 57 75 25 43 18 52 19
54 69 80 22 47 48 49 58 51
