10
74 63 7 39 75 42 70 89 16 15
5 46 34 47 41 40 92 38 9 84
48 65 71 35 72 3 11 97 12 99
96 77 87 44 36 64 58 19 83 8
88 2 26 94 68 66 18 49 52 17
61 25 85 67 43 90 22 98 13 53
27 59 31 33 79 73 69 93 91 0
57 30 6 60 20 56 81 4 21 51
29 23 37 28 50 24 95 45 54 76
62 1 32 80 14 86 78 82 10 55
