14
55 130 95 54 96 97 62 182 10 63 7 167 164 140
4 162 103 52 189 94 191 184 5 179 105 183 20 168
8 2 131 35 6 136 56 134 9 99 71 65 108 107
1 91 57 98 53 133 59 69 135 13 67 70 19 15
48 161 158 84 92 14 165 60 104 61 11 163 12 110
46 128 192 144 181 51 100 68 16 106 113 142 102 17
160 45 47 90 174 141 172 49 169 66 195 23 166 112
44 39 83 132 159 101 157 146 73 185 187 143 64 77
88 126 124 93 173 171 129 109 119 78 72 74 193 145
190 38 139 121 123 33 36 138 137 120 0 186 21 18
89 178 86 127 3 79 122 175 34 115 26 155 22 75
58 50 41 154 194 82 42 150 32 118 180 170 116 147
40 156 81 28 151 85 176 152 177 29 149 114 24 25
37 43 153 87 30 80 188 125 148 111 76 31 27 117
