14
2 1 162 159 5 189 57 8 12 6 105 15 9 163
52 97 56 3 100 140 194 53 107 7 104 20 13 167
132 95 102 91 103 134 16 183 110 106 58 17 66 185
98 192 139 54 156 101 34 135 10 11 160 68 67 166
50 130 49 55 172 193 180 63 161 195 70 136 184 62
51 60 45 4 87 109 155 61 178 144 169 65 142 19
96 93 94 176 181 177 89 38 186 125 26 138 59 64
179 43 129 164 149 35 81 133 182 174 69 117 113 77
41 47 175 158 145 153 48 118 21 188 29 18 165 25
128 99 171 123 86 79 0 83 131 71 116 74 119 108
92 39 44 190 84 126 137 111 80 32 148 23 141 14
37 46 115 124 127 36 150 82 121 28 27 72 73 146
40 151 154 85 157 33 152 31 170 173 114 78 168 76
122 42 88 30 90 112 120 75 187 147 22 143 24 191
