13
10 44 123 49 7 158 52 125 15 147 61 149 12
1 4 117 88 95 124 92 11 98 63 16 23 129
48 120 116 162 119 83 127 151 94 59 99 13 60
41 45 55 5 103 8 53 14 57 62 18 90 96
47 87 86 3 93 146 51 24 9 6 121 56 85
140 144 2 46 54 139 126 161 50 42 106 122 152
80 109 82 156 37 75 39 168 137 17 64 138 163
34 65 115 157 43 131 142 164 133 101 58 108 105
76 36 0 97 118 91 72 84 128 143 68 20 102
31 40 159 35 150 154 141 111 70 21 19 29 22
89 33 165 136 81 74 145 25 135 148 104 30 67
113 79 132 160 32 167 155 73 134 112 26 107 27
77 114 78 38 66 110 166 71 153 28 69 130 100
