8
57 51 37 45 27 28 62 32
38 63 6 55 20 3 35 7
16 26 46 61 36 47 39 4
14 60 5 59 42 40 56 2
50 48 11 54 30 24 10 33
41 25 44 17 19 49 21 23
34 31 12 0 9 52 58 43
13 53 22 1 29 18 15 8
