8
1 2 3 4 5 6 7 8
28 29 30 31 32 33 34 9
27 48 49 50 51 52 35 10
26 47 60 61 62 53 36 11
25 46 58 59 63 54 37 12
24 45 43 57 0 56 38 13
23 44 42 19 40 55 39 14
22 21 20 18 41 17 16 15
