8
2 57 63 4 24 35 19 50
17 60 12 59 62 61 8 43
37 0 23 28 39 3 16 51
7 14 53 56 54 32 30 58
55 15 29 20 31 25 27 10
36 1 49 13 40 22 44 52
5 6 42 26 18 46 33 11
34 48 38 9 47 45 21 41
