8
41 28 9 12 11 49 7 47
25 18 57 21 45 34 3 1
26 40 52 22 20 15 31 0
59 17 27 53 5 6 8 37
14 23 29 55 39 16 36 4
56 54 35 50 58 61 2 62
42 32 30 51 19 46 43 33
48 44 60 10 24 13 38 63
