8
1 2 3 4 5 6 8 9
28 29 30 31 32 34 7 10
27 48 49 50 51 33 35 52
26 47 60 62 53 54 0 11
25 46 59 61 63 37 36 12
24 45 58 57 56 55 38 13
23 44 43 42 41 40 39 14
22 21 20 19 18 17 16 15
