8
1 2 3 4 5 52 6 8
28 48 29 30 31 33 7 9
27 0 49 50 32 35 34 10
26 47 60 61 51 53 36 11
25 46 59 63 62 54 37 12
24 45 58 57 56 55 38 13
23 44 43 42 41 40 39 14
22 21 20 19 18 17 16 15
