13
1 2 3 4 5 6 7 8 9 10 11 12 13
48 49 50 51 52 53 54 55 56 57 58 59 14
47 88 89 90 91 92 93 94 95 96 97 60 15
46 87 120 121 122 123 124 125 126 127 98 61 16
45 86 119 144 145 146 147 148 149 128 99 62 17
44 85 118 143 160 161 162 163 150 129 100 63 18
43 84 117 142 159 168 0 164 151 130 101 64 19
42 83 116 141 158 167 166 165 152 131 102 65 20
41 82 115 140 157 156 155 154 153 132 103 66 21
40 81 114 139 138 137 136 135 134 133 104 67 22
39 80 113 112 111 110 109 108 107 106 105 68 23
38 79 78 77 76 75 74 73 72 71 70 69 24
37 36 35 34 33 32 31 30 29 28 27 26 25
